abase - to humble; disgrace
aberrant - markedly different from an accepted norm
abeyance - disuse
abject - most unfortunate or miserable
abjure - to renounce
aboveboard - legitimate, honest
abraded - eroded
abrogate -  revoke formally
abrogate - deny
abscission  the act of cutting something off
abstemious - self denying
abut - ro adjoin
abysmal - very great
acarpous -  no longer fertile; worn out
accession - agreeing with or consenting to (often unwillingly)
acerbic - harsh or corrosive in tone
acidulous - sour in taste or manner
acquiesce - to agree or express agreement
acrophobia - fear of heights
acumen - keenness of judgment or insight
adulterate - corrupt, debase, or make impure by adding a foreign or inferior substance
adumbrate - indicate
aerie - a nest built high in the air; an elevated, often secluded, dwelling
aesthete - one who values beauty in art
aesthetic - concerning or characterized by an appreciation of beauty or good taste
affective   characterized by emotion
agape - open-mouthed; surprised; agog
agglutination - the coalescing of small particles that are suspended in solution
aggregate - gather in a mass, sum, or whole
allay - to lessen
allege - to assert without proof or confirmation
alloy - to debase by mixing with something inferior
allusion - passing reference or indirect mention
amalgamate - to bring or combine together or with something else
ambiguous - having more than one possible meaning
ameliorate - make better
amenable - disposed or willing to comply
amenable - easy to persuade
amity   a cordial disposition
amorous - inclined toward or displaying love
amorphous - lacking in shape
amortize - to diminish by installment payments
anachronistic   chronologically misplaced
analogue - something similar
anathema    an object of intense dislike; a curse or strong denunciation
ancillary - subordinate or supplementary
anodized - electroplated
anodyne - something that calms or soothes pain
antediluvian - outdated
anthropocentrism - putting man at the center of one's philosophy
antipathy - a feeling of intense dislike
apocryphal - of doubtful origin
apogee - farthest point from the earth in the orbit of a heavenly body
apostate - a disloyal person who betrays or deserts his cause or religion or political party or friend etc.
apotheosis - elevation to godhood; an ideal example of something
apposite - appropriate; fitting
apprise - make aware of
approbation - official recognition or approval
arabesque - ornate design featuring intertwined curves
arable - can be cultivated
arcane - requiring secret or mysterious knowledge
archaic - so extremely old as seeming to belong to an earlier period
archetype - an original model on which something is patterned
ardent - characterized by intense emotion
ardor - feelings of great warmth and intensity
arduous - difficult to accomplish
arrant  thoroughgoing, out-and-out; shameless, blatant
arrest - cause to stop
arrogate - to claim without justification; to claim for oneself without right
artless - without guile; open and honest
ascetic - without luxuries
asperity - critical tone
asperity - severity, harshness
aspersion - an abusive attack on a person's character or good name
assay - an appraisal of the state of affairs
asseverate  to affirm earnestly and with emphasis
assiduous - diligent
assuage - to calm
astringent - tending to draw together or constrict soft organic tissue; sour or bitter in taste
atavism - reappearance of ancestral traits
attenuated - weakened in force or effect
attrition   a wearing down to weaken or destroy
augury - prophecy; prediction of events
august - profoundly honored
auspice - a favorable omen
auspicious  attended by favorable circumstances
auspicious - favorable; opposite to sinister
aver - affirm
baleful deadly or sinister
banal - obvious and dull
banality - ordinariness
bane -  something causes misery or death
base - despicable
beatify -  make blessedly happy
bedizen - dress up garishly and tastelessly
beget - to produce; to make happen
beleaguer - annoy persistently
belie - to contradict
bellicose - aggressive
benignity - compassion
bent - a relatively permanent inclination to react in a particular way
bereave - to make desolate with loneliness and grief
bilge - bulge; the protuberance of a cask
bilk - cheat
blandish -  to coax by using flattery
blandishment - words used to coax
blithe - carefree and happy and lighthearted
bolster - support and strengthen
bombast - arrogant
boorishness - insensitive
bromide - commonplace/boring person
brook   put up with something or somebody unpleasant
bulwark - wall
burnish - to polish
buttress - support
byzantine - highly involved or intricate
cabal - a clique (often secret) that seeks power usually through intrigue
cachinnate -  laugh loudly and in an unrestrained way
cadge - to get by begging
callow - immature
calumniate -  charge falsely or with malicious intent
calumny - a false and malicious accusation; misrepresentation
canard - rumor/false report
cant - insincere talk
capacious - spacious
caparison - to adorn or bedizen
capitulate -  surrender under agreed conditions
caprice - whim; sudden change of mind without any real cause
capricious - changing one's mind quickly and often
captious -  excessively ready to find fault; given to petty criticism; intended to trap, confuse, or show up
cardinal - serving as an essential component
caret - a mark used by an author or editor to indicate where something is to be inserted into a text
caterwauling -  a shrill, discordant sound
causus - private political meeting
cavalcade - procession of vehicles
cavalier - carefree, happy; with lordly disdain
cavil - raise trivial objections
celerity -  swiftness, rapidity of motion or action
censure - harsh criticism or disapproval
centrifuge - device to separate substances by spinning them at high speed
certitude - certainty
chagrin - strong feelings of embarrassment
chary - wary of
chasten correct by punishment or discipline
chauvinist - a person with a prejudiced belief in the superiority of his or her own kind
chicanery - the use of tricks to deceive someone (usually to extract money from them)
chide - censure severely or angrily
chimera - a grotesque product of the imagination
chimerical - created by or as if by a fanciful imagination
choleric -  quickly aroused to anger
churlish -  lacking politeness or good manners; lacking sensitivity; difficult to work with or deal with; rude
circumlocution - long-windedless
circumscribe - limit
circumscribe - restrict something within limits
circumspect - careful, cautious
cleave - separate or cut with a tool, such as a sharp instrument
cloture - closure
coalesce - fuse or cause to grow together
coda - finale
coeval  of the same period
cogent - powerfully persuasive
collate - arrange in order
comely - very pleasing to the eye
commensurate - equal in significance
complaisance - a disposition or tendency to yield to the will of others
conciliation - appeasement, pacification
conflagration - big fire
conflate -  mix together different elements
consonant - involving or characterized by harmony
consternation - dismay, confusion
consummate - perfect and complete in every respect
contemn - look down on with disdain
contemptuous - feeling hatred; scornful
contentious - involving or likely to cause controversy
contumacious - stubborn
convivial - friendly, enjoyable
cosmopolitan - well versed in many cultures
coterie - clique
countenance - consent to, give permission
cozen - cheat or trick
craven - lacking even the rudiments of courage
credulous - gullible
crepuscular - active at dawn and dusk
cupidity - excessive greed (esp. money)
damp - lessen in force or effect
declaim - to say loudly; to speak loudly and with force about sth you feel strongly about, esp. in public
decorous -  characterized by propriety and dignity and good taste in manners and conduct
defalcate - embezzle
deleterious - harmful
demagogue   an orator who appeals to the passions and prejudices of his audience
demur - to express doubts or objections
demure - affectedly modest or shy especially in a playful or provocative way
deplore - regret
deposition -  the act of putting something somewhere
deprecate - belittle
depredate - to plunder and pillage
derogated - detracted from
descant - talk at great length about something of one's interest
descry - catch sight of
descry - to see
desiccate - lose water or moisture
desuetude - a state of inactivity or disuse
desultory - aimless
diachronic - occurring across time
diaphanous - transparent
diffidence - modesty/shyness (from lack of confidence)
diffident - lacking self-confidence
diffuse - spread out
dilatory -  tending to delay or procrastinate
dilettante - dabbling in a subject without serious study
disabuse - to free from deception or error, set right in ideas or thinking
disaffect - arouse hostility or indifference in where there had formerly been love, affection, or friendliness
disapprobation - disapproval
discomfit - cause to lose one's composure
discountenance - disallow
discursive- (of e.g. speech and writing) tending to depart from the main point or cover a wide range of subjects
discursiveness - indirectness
disingenuous - not straightforward; crafty
disinterestedness - not influenced by considerations of personal advantage
dissemble - hide under a false appearance
distrait -  having the attention diverted especially because of anxiety
diurnal - active in daytime
doggerel -  trivial, poorly constructed verse
doleful - mournful, sad
dolorous -  showing sorrow
dross - worthless material that should be removed
dulcet - extremely pleasant in a gentle way
ebullience- overflowing with enthusiasm
edacious  - voracious, devouring
edifying  - enlightening or uplifting so as to encourage intellectual or moral improvement
efface - wipe out
effluvia  - outflow in a stream of particles a noxious odor or vapor
effrontery- audacious (even arrogant) behavior that you have no right to
effusive  - extravagantly demonstrative
effusive - gushing
egregious - conspicuously and outrageously bad or reprehensible
egress - exit
elegy - a mournful poem
emollient - having a softening or soothing effect especially to the skin
encomium -  a formal expression of praise
endemic - native to or confined to a certain region
enervate - weaken
ensconce - establish firmly
epaulet - shoulder decoration
epicure - someone who likes good food/drink
epithet - a defamatory or abusive word or phrase
equanimity - calmness, composure, refusal to panic
equipoise - equality; balance; equilibrium
equivocal - open to two or more interpretations
equivocate - be deliberately ambiguous or unclear in order to mislead or withhold information
equivocation - the use of ambiguous language to conceal the truth or to avoid committing oneself; prevarication
erudite - having or showing profound knowledge
erudite - scholarly
erudition - learning
espouse - take up the cause, ideology, practice, method, of someone and use it as one's own
essay - make an effort or attempt
estimable - deserving of respect or high regard
ethereal - characterized by lightness and insubstantiality
euphony - any agreeable (pleasing and harmonious) sounds
evanescent - vanishing, soon passing away; light and airy
evince - give expression to
eviscerated - to disembowel - remove something of central significance
excoriate - express strong disapproval of
exculpate - pronounce not guilty of criminal charges
execrable - very bad
exegesis - scholarly explanation
exemplar - something to be imitated
exhort - urge on or encourage especially by shouts
exigency - urgent matter
exigent - urgent
expatiate - to expand on, write or talk at length or in detail; to move about freely
expiate - atone
expostulate - to offer strong objections
expurgate - edit by omitting or modifying parts considered indelicate
exscind - to cut out cut away
extant - still in existence
extemporaneous - with little or no preparation or forethought
extemporize - speak without preparation
extend - span an interval of distance, space or time
extirpate - destroy completely, as if down to the roots
extraneous - not essential
facetious - cleverly amusing in tone
facile -  performing adroitly and without effort
fallow  inactive; unproductive
fatuous - complacently or inanely foolish
feckless -  generally incompetent and ineffectual
fecund - fertile
felicitious - well suited, appropriate, delicious, good companion
fervid - passionate
filigree -  delicate and intricate ornamentation (usually in gold or silver or other fine twisted wire)
flag - become less intense
flip - marked by casual disrespect
florid  elaborately or excessively ornamented
flounder - behave awkwardly
flout - treat with contemptuous disregard
foment - stir up
forbearance - a delay in enforcing rights or claims or privileges
forswear - formally reject or disavow a formerly held belief, usually under pressure
forte - an asset of special worth or utility
fortuitous - happening by accident or chance rather than design
founder - stumble and nearly fall, fail utterly
fracas -  noisy quarrel
fractious - easily irritated or annoyed
frieze - ornamental horizontal band on a wall
froward - habitually disposed to disobedience and opposition
fulminate - explode noisily
fulsome - unpleasantly and excessively suave or ingratiating in manner or speech
funereal - depressing (like a funeral)
fusillade - gunfire
gainsaid - deny
gainsay - contradict
gambit - a maneuver in a game or conversation
gambol -  gay or light-hearted recreational activity for diversion or amusement
garrulous - talkative
gauche - lacking social graces; tactless
gauntlet -  dare, provocation, trial, punishment
gawkishness - awkwardness, clumsiness
genial - diffusing warmth and friendliness
gentry - people or good birth or high social status
germane - relevant
gerontocracy - government by the aged
glib - marked by lack of intellectual depth
gnostic - possessing intellectual or esoteric knowledge of spiritual things
gossamer -  characterized by unusual lightness and delicacy
grandiloquence - high flown style
gratuitous - unnecessary and unwarranted
gravitas -  formality in bearing and appearance
grouse - complain
gustatory - about the sense of taste
guy - a rope or cable that is used to brace something (especially a tent)
hackneyed - repeated too often
halcyon - happy and calm
harrow - to distress, create stress or torment
hawser - cable
hectoring - bullying
hegemony - domination over others
heterodox - unorthodox
hidebound - rigid in opinions
hirsute - having or covered with hair
histrionic - exaggerated, theatrical, melodramatic
homiletics  the branch of theology that deals with sermons and homilies
hortatory - encouraging
iconoclast - person who opposes orthodoxy
idyll - an episode of such pastoral or romantic charm as to qualify as the subject of a poetic idyll
ignoble - completely lacking nobility in character or quality or purpose
ignomonious - humiliating
illiberal - stingy
imbroglio - a very embarrassing misunderstanding
impassive - having or revealing little emotion or sensibility
impecunious - having no money
impecunious - poor; having no money
imperious   arrogantly domineering or overbearing
impetuous - characterized by undue haste and lack of thought or deliberation
impiety - lack of reverence or dutifulness
importune - beg persistently and urgently
imprimatur - formal and explicit approval
imprudent - unwise
impugn - attack as false or wrong
impute - attribute or credit to
incandescent -  characterized by ardent emotion or intensity or brilliance
inchoate - not fully formed; disorganized
incipient - just beginning
indefatigable - showing sustained enthusiastic action with unflagging vitality
indemnified - compensated for harm or less
indemnify - protect against loss or damage
indigence - poverty
indolent - disinclined to work or exertion
ineffable - defying expression or description
ineffable - incapable of being expressed
inefficacious - ineffective
ineluctable - certain, inevitable
inerrancy - making no mistakes or errors
inexorable - relentless
ingenuous - lacking in sophistication or worldliness
inimical - hostile, unfriendly
iniquitous - evil
innervate - stimulate to action
innuendo - indirect information
inscrutable - difficult to understand
insensible -  unresponsive to stimulation
insipid - lacking interest or significance
insouciant -  marked by blithe unconcern
instransigent - unyeilding
insular - narrowly restricted in outlook or scope
intemperance - consumption of alcoholic drinks
intemperate - excessive
interdict   command against
interregnum - pause or interruption
intimate - imply as a possibility
intractability - resistance
intractable - stubborn, not easily controlled
intransigence - stubbornness
inundate - fill or cover completely, usually with water
inured - made tough by habitual exposure
invective - abusive or venomous language used to express blame or censure or bitter deep-seated ill will
inveigh - speak against in an impassioned manner
inveigle - coax
inveterate - habitual
involute -  intricate; complex; convoluted
irascible - easily angered
irony - incongruity between what might be expected and what actually occurs
itinerant - nomadic
jejune -  displaying or suggesting a lack of maturity
jejune - without significance, dull
jocose -  given to jesting; playfully humorous; jocular
lachrymose - sad
laconic - brief
lacuna - missing part
lambaste - criticize harshly
lament - regret strongly
languish - decay
languorous -  lacking spirit or liveliness
largess - liberality in bestowing gifts
lascivious - driven by lust
lassitude - lack of energy
levity - lightness of manner
libertine - unrestrained by convention or morality
limn -  trace the shape of
limpid - transparently clear
lionize - give a lot of public attention and approval to someone
loath - reluctant
loquacious - talkative
lubricious - lewd, wanton, greasy, slippery
luculent -  easily understood, lucid, clear
lugubrious -  excessively mournful
macerate - chop into tiny pieces
maculate -   spot, stain, or pollute
maelstrom - storm in the ocean
magnanimity - liberality in bestowing gifts
magnate - powerful businessman
malinger - shirk/avoiding work
manacled - restrained
martinet - someone who believes in strict discipline
maunder - to talk in a rambling way; to move aimlessly
maverick - independent in behavior or thought
maxim - a general truth or rule of conduct; a short saying
mellifluous - having a rich, smoothly flowing sound
mendacious - given to lying
mendacity - the tendency to be untruthful
mendicant - a pauper who lives by begging
mercurial - (of a person) subject to sudden or unpredictable changes of mood or mind
meretricious -  tastelessly showy
milieu - environment
militate -  have force or influence
minatory - threatening
mince - make less severe or harsh
mollify - make more temperate, acceptable, or suitable by adding something else
mordant - harshly ironic or sinister
moribund - on the point of death
mote - small particle, speck
multifarious - diverse
munificent - generous
myriad - a large indefinite number
nadir - lowest point
nascent - coming into existence
natty -  neatly or smartly dressed
nebulous - cloudlike, resembling a cloud; cloudy in color, not transparent; vague, confused, indistinct
neologism - the act of inventing a word or phrase
neophyte  - any new participant in some activity
nexus - a link, tie, or bond
nice -  excessively fastidious and easily disgusted
noisome - offensive or disgusting; foul-smelling; harmful or injurious
nominal - being such in name only
nonplused - filled with bewilderment
nostrum - remedy
nugatory - futile
numismatic - coin collecting
obdurate - resistant to persuasion
oblique - indirect
obloquy - verbal abuse
obsequious - excessively obedient
obstreperous -  boisterously and noisily aggressive
obtuse - slow to learn or understand
obviate - prevent the occurrence of
occlude - to stop up; prevent the passage of
occlusion - blockage 
occult - hide from view
odious - unequivocally detestable
officious   intrusive in a meddling or offensive manner
onerous - burdensome
onus - burden
opprobrious - expressing great scorn
opprobrium - public disgrace
ornery - having a difficult and contrary disposition
ossified -  set in a rigidly conventional pattern of behavior, habits, or beliefs
ossify - turn to bone
ostensible - appearing as such but not necessarily so
overweening - presumptuously arrogant
paean - praise
palisade - fence made of posts
palliate -  lessen or to try to lessen the seriousness or extent of
palpate - to examine with hands
panache - distinctive and stylish elegance
panegyric - speech praising someone
parochial - narrow in scope; provincial
parry - to avoid
parsimonious - extremely frugal, stingy
pastiche - work from varied sources
peccadillo - a petty misdeed
pedagogy - the activities of educating or instructing or teaching
pedant - showy in one's learning; overly instructive
pedantic - marked by a narrow focus on or display of learning especially its trivial aspects
pedestrian  lacking wit or imagination
pellucid    (of language) transparently clear
pellucid - easily understood
penury - poverty
peregrination -  travel (especially by foot)
peremptory -  not allowing contradiction or refusal
perennial - lasting an indefinitely long time
perfidious - willing to betray one's trust
perfidy - treachery
perfunctory - hasty and without attention to detail; as a formality only
perigee - nearest point to the earth in the orbit of a heavenly body
peripatetic - nomadic
pernicious - exceedingly harmful
pernurious - extremely stingy; poor, inadequately supplied
peroration - (rhetoric) the concluding section of an oration
perpetuity - eternity
persepacious - showing good judgement
pertinacious - firmly held
petrous like a rock, hard, stony
phenomenology - study of things the way they are perceived
philistine - one who treats art derisively
phlegmatic  showing little emotion, calm
picaresque  involving clever rogues or adventurers especially as in a type of fiction
picayune - insignificant
pied -  having sections or patches colored differently and usually brightly
pillory - criticize harshly or violently
piquant - engagingly stimulating or provocative
pique - cause to feel resentment or indignation
pith - center/essence
pithy - concise and full of meaning
plaintive - expressing sorrow
plangent  - loud and resounding
poignant - deeply affecting, touching; keen or sharp in taste or smell
polemical - causing debate
ponderous - moving with great effort
portend - foretell
portentious - ominous
potlatch - wild party
prate - speak (about unimportant matters) rapidly and incessantly
precipitate - act quickly
precis - a sketchy summary of the main points of an argument or theory
prescient - fore-knowledge
presentiment - feeling that something might happen
prevaricate - speak misleadingly and evasively
prevaricate be deliberately ambiguous or unclear in order to mislead or withhold information
privation - a state of extreme poverty
probity - honesty
profligate - corrupt; degenerate
prolix - excessively long and wordy (of a person, piece of writing, etc.) 
prolix - tediously prolonged or tending to speak or write at great length
propinquity the property of being close together
propitiate  to conciliate; to appease
prosaic - dull
proscribe - forbid
proscribed - forbidden
provident - providing carefully for the future, frugal
provincial - lacking sophistication, narrow-minded
puerile - childish
puissance - power
pullulation - a rapid and abundant increase
punctilious - marked by precise accordance with details
pundit - a learned person; one who gives authoritative opinions
purloin - steal
pursuant - in conformance to or agreement with
pusillanimous - cowardly
quay -  wharf usually built parallel to the shoreline
quiescence - stillness; motionlessness; quality of being at rest
quisling - traitor
quixotic - foolishly impractical and idealistic
quotidian - routine
raconteur - story teller
raffish - cheaply vulgar in appearance or nature; tawdry; disreputable
ramify - grow and send out branches or branch-like structures
rampart - an embankment built around a space for defensive purposes
rancorous - showing deep-seated resentment
rapacious - excessively greedy and grasping
rarefy - to make or become thin, less dense; to refine
rebus - a puzzle where you decode a message consisting of pictures representing syllables and words
recalcitrant - having an obstinately uncooperative attitude toward authority or discipline
recalcitrant - stubbornly disobedient, resisting authority
recapitulate - summarize
recidivism  habitual relapse into crime
recondite - difficult to understand; profound
reconnoiter - explore, often with the goal of finding something or somebody
recreant -  an abject coward
redolent - smelling
redoubtable - inspiring fear
referendum - public vote
refractory - stubbornly resistant to authority or control
refulgent - radiant
regale - to entertain or delight
remonstrate - argue in protest or opposition
remuneration - payment
renege - to fail to honor a commitment; to go back on a promise
rent -  an opening made forcibly as by pulling apart
repine -  to be discontented or unhappy; to long for something
replete - full; abundant
reprimand - scold
reprobate -  a person without moral scruples
reprobate - one who is morally unprincipled
reprove - to find fault with, scold, rebuke
repudiate - shun
repugnant - to oppose or fight against
restive - impatient, uneasy, or restless
reticent - temperamentally disinclined to talk, reluctant to draw attention to yourself
ribald  - humorously vulgar
rococo - heavily embellished
rogue - an unprincipled or dishonest person
rota - period of work done in rotation with others
rubicund    inclined to a healthy reddish color often associated with outdoor life
rubric - category name
ruminate - ponder
runic   - mysterious; magical
runic - mysterious, secret in meaning
saccharin - falsely sweet
sagacious - acutely insightful and wise
salacious - suggestive of or tending to moral looseness
salient - prominent; of notable significance
salubrious - health-giving
salutary - something which teaches you a lesson
sanatorium -  pejorative terms for an insane asylum
sanction - endorse
sanction - give authority or permission to
sanguinary - bloody
sanguine -  confidently optimistic and cheerful
sartorial - of or relating to a tailor or to tailoring
saturnine - showing a brooding ill humor
schism - division
scotch - disable
scurrilous  expressing offensive reproach
scurvy - contemptible, despicable
sedulity - thoroughness
sedulous -  marked by care and persistent effort
sedulous - persistent, showing industry and determination
seine - a large fishnet that hangs vertically, with floats at the top and weights at the bottom
sententious - abounding in or given to pompous or aphoristic moralizing
sepulchral - suited to or suggestive of a grave or burial
sidereal -  of or relating to the stars or constellations
simper - to smirk, smile foolishly
sinecure - good paying job requiring little effort
sinecure - job or position requiring little or no work
sinistral - left handed
sinuous - curved or curving in and out
skullduggery - unfair or dishonest practices carried out in a secretive way in order to trick other people
solicitous - full of anxiety and concern
solvent - capable of meeting financial obligations
somatic - concerned with the body
sophistry -  reasoning that seems plausible but is actually unsound; a fallacy
soporific -  sleep inducing
soubriquet - a familiar name for a person (often a shortened version of a person's given name)
sparing - avoiding waste
specious - false
spendthrift - reckless in regards to spending
splenetic - very irritable
sportive - playful and frolicsome
stanch - stop the flow of a liquid
stentorian - extremely loud and powerful
stevedore - dockworker
stint - supply sparingly and with restricted quantities
stipple - to cover with dots of paint
stolid - impassive
stolid - unemotional, impassive
strident -  unpleasantly loud and harsh
strident - loud or strongly expressed
stygian - very dark, forbidding
subpoena - a writ issued by court authority to compel the attendance of a witness at a judicial proceeding
substantiation - proof with evidence
succor - assistance in time of difficulty
supine - offering no resistance
supplant - take the place or move into the position of
suppliant -  humbly entreating
supplicant - one praying humbly for something
surfeit - the state of being more than full
sybarite - lover of luxury
syllogism - type of logical reasoning
taciturn - habitually silent or quiet, inclined to talk very little
tamp -  press down tightly
temerity - boldness
tendentious - biased
tendentiousness - expressing a particular cause
tender - to offer
tenebrous - obscure, difficult to understand
tenuous - flimsy
tetchy - easily irritated or annoyed
timorous -  timid by nature or revealing timidity
toady - a person who tries to please someone in order to gain a personal advantage
tonicity -  the elastic tension of living muscles, arteries, etc. that facilitate response to stimuli
torpid - slow and apathetic
torpor - extreme mental and physical sluggishness
torrid - emotionally charged and vigorously energetic
tortuous - indirect
tractable - polite
trenchant - vigorous or incisive in expression or style
truculent - defiantly aggressive
tumid - abnormally distended especially by fluids or gas
tumid - swollen, affected with swelling
turbid -  cloudy, muddy; in a state of turmoil
turbid - think, dense
turgid -  abnormally distended especially by fluids or gas
turpitude -  a corrupt or depraved or degenerate act or practice
tyro - novice
unalloyed - total
unctuous - oily
unprepossessing - unattractive
unstinting - given without restraint
untenable - not capable of being held or defended; impossible to maintain
untoward -  not in keeping with accepted standards of what is right or proper in polite society
upbraid - to blame, scold, find fault with
upbraid - to reproach
urbane - showing a high degree of refinement and the assurance that comes from wide social experience
usury - the act of lending money at an exorbitant rate of interest
vagary - freak
variegated - multicolored
vaunt - to boast; to brag about
venal - corrupt
venality - the condition of being susceptible to bribes 
venerate - regard with profound respect
venial - minor
verisimilar - true to life
verisimilitude - the quality of appearing to be true, real, likely, or probable
vicissitude - unexpected change
vindicate - to free from blame
virago -  a noisy or scolding or domineering woman
virulent -  extremely poisonous or injurious
vitiate - weaken
vitiated - impaired in quality
vituperate - attack bitterly, criticize
vociferous - noisy
volubility - excessive talkativeness
volubility - noun
vulpine - like a fox
wag - a witty amusing person who makes jokes
wallow - roll about lazily, submerse oneself in
welter - toss, roll, or rise and fall in an uncontrolled way
wend -  direct one's course or way
whimsical - determined by chance or impulse or whim rather than by necessity or reason
wizened - lean and wrinkled by shrinkage as from age or illness
